1111111111111
1001000000001
1000011111001
1E00C0P0000A1
1111111111111