111111111111111111
1PC000000000000001
101010101010101001
101010101010101001
10101010101X1E1001
111111111111111111